1111111111111111
1P000B000B000001
1000C11110000001
1000111111110001
1000C11110000001
1000CBB011110001
1000000C00C000E1
1111111111111111