1111111111111111
1P00000000000001
1000C1111C000001
1000111111110001
1000C1111C000001
1000000011110001
10000000000000E1
1111111111111111