111111111
1PPPPPPP1
1EEECEEE1
111111111