1111111111111111111111111111111111
1E0000000000000C00000C000000C00001
1010010100100000101001C0CCCCC10101
1010010010101010001001000000010101
1P0000000C00C00000000C0000000000C1
1111111111111111111111111111111111